#module 0 size: 31 bs: 0.012977
0 3 4 8 11 12 14 15 16 18 20 21 23 24 29 33 34 35 36 37 38 40 43 44 45 50 51 52 55 58 59 
#module 1 size: 21 bs: 0.00748729
1 5 6 7 9 13 17 19 22 25 26 27 30 31 32 41 48 54 56 57 60 
#module 0 size: 31 bs: 0.0770705
0 3 4 8 11 12 14 15 16 18 20 21 23 24 29 33 34 35 36 37 38 40 43 44 45 50 51 52 55 58 59 
#module 1 size: 20 bs: 0.0102852
1 5 6 7 9 13 17 19 22 25 26 27 30 31 32 41 48 54 56 57 
#module 0 size: 36 bs: 0.00964409
0 2 3 4 8 10 11 12 14 15 16 18 20 21 23 24 28 29 33 34 35 36 37 38 40 42 43 44 45 47 50 51 52 55 58 59 
#module 1 size: 25 bs: 0.00843252
1 5 6 7 9 13 17 19 22 25 26 27 28 30 31 32 36 39 41 47 48 54 56 57 60 
#module 0 size: 39 bs: 0.0164586
0 2 3 4 8 10 11 12 14 15 16 18 20 21 23 24 28 29 30 33 34 35 36 37 38 40 42 43 44 45 47 50 51 52 53 55 58 59 61 
#module 1 size: 21 bs: 0.0102631
1 5 6 7 9 13 17 19 22 25 26 27 30 31 32 41 48 54 56 57 60 
#module 0 size: 31 bs: 0.0102852
0 3 4 8 11 12 14 15 16 18 20 21 23 24 29 33 34 35 36 37 38 40 43 44 45 50 51 52 55 58 59 
#module 1 size: 21 bs: 0.0102631
1 5 6 7 9 13 17 19 22 25 26 27 30 31 32 41 48 54 56 57 60 
#module 0 size: 21 bs: 0.0974197
1 5 6 7 9 13 17 19 22 25 26 27 30 31 32 41 48 54 56 57 60 
#module 1 size: 35 bs: 0.00468043
0 2 3 4 8 10 11 12 14 15 16 18 20 21 23 24 29 33 34 35 36 37 38 40 42 43 44 45 47 50 51 52 55 58 59 
#module 0 size: 31 bs: 0.0167504
0 3 4 8 11 12 14 15 16 18 20 21 23 24 29 33 34 35 36 37 38 40 43 44 45 50 51 52 55 58 59 
#module 1 size: 21 bs: 0.0280229
1 5 6 7 9 13 17 19 22 25 26 27 30 31 32 41 48 54 56 57 60 
#module 0 size: 21 bs: 0.0411395
1 5 6 7 9 13 17 19 22 25 26 27 30 31 32 41 48 54 56 57 60 
#module 1 size: 33 bs: 0.010833
0 3 4 8 10 11 12 14 15 16 18 20 21 23 24 29 33 34 35 36 37 38 40 42 43 45 47 50 51 52 55 58 59 
#module 0 size: 30 bs: 0.0267028
0 3 4 8 11 12 14 15 16 18 20 21 23 24 29 33 34 36 37 38 40 43 44 45 50 51 52 55 58 59 
#module 1 size: 21 bs: 0.0102631
1 5 6 7 9 13 17 19 22 25 26 27 30 31 32 41 48 54 56 57 60 
#module 0 size: 31 bs: 0.0102851
0 3 4 8 11 12 14 15 16 18 20 21 23 24 29 33 34 35 36 37 38 40 43 44 45 50 51 52 55 58 59 
#module 1 size: 21 bs: 0.0102631
1 5 6 7 9 13 17 19 22 25 26 27 30 31 32 41 48 54 56 57 60 
